####################
#  *            *  #
#*################*#
#   **     #       #
######  ######**####
##***#* * #    *#  #
#  #    # #  #  #*##
#  #**    *  #  #  #
#  ###### *  *  ## #
#  #  #   * # #*#  #
##* * *   *###     #
# # ### # * ##**** #
#  * * *  * # * # *#
# # # # ### # * #  #
##*  *  * * # * #* #
#  ##*## #* # #*#  #
#  *   #   *   *   #
#  # # #   #** ##**#
#      *   #   *   #
####################
cele K
help
Plansza trzecia  - musisz pokonać przeciwnika patrolującego górną część planszy