####################
#   *      *       #
# # *      # # ##  #
# #      ### #*#   #
#   #        *     #
#   #        # ##* #
#                  #
# ###     *##*  #  #
#   *  #  *   # #  #
# # *  #  #     #  #
# # #  #  #   #*#  #
# # #  ####        #
# # #             ##
# #    ##*# # #   ##
# # #  #  # ###   ##
# * #  #  #        #
# * #**#      #    #
#      ###   ###**##
#                  #
####################
cele S, K
help
Plansza czwarta - musisz przeżyć 2 minuty lub zabić wszystkich przeciwników
