####################
#  #      #    #####
#**#    **#**  * * #
#  #*###  #  #####*#
#    #  *****  #   #
#  ##   ##### ##*# #
#  # * *  *  * * # #
#  #  # ##*## #  #*#
#  #  # #***# #  # #
####*##*** ***##*###
#  #  # #***# #  # #
#  #  # ##*## #  # #
#  # * *  *  * * # #
#  #*#  #####  ### #
#    #  *****  #   #
#*######  #  ###*# #
# * *   **#**    # #
#####     #      #*#
# *       #      # #
####################