####################
# #**  *     *     #
#* * #########   #*#
# ####  #* *   ##  #
##*  #**  # ###  **#
#**# * #*####** ####
##*## #  ##    #   #
#** # * #***## # # #
##* ### * #   ## # #
#** * # * # **   # #
# ########**# ## # #
# *#***     ##  #  #
## #  ######    #  #
# **  *  # ####*## #
#######*   *  # # *#
# *  #  #####   #*##
# #   * #  #  *## *#
#**###** #  **  ## #
#      # *   #     #
####################
